%%%%%%%%%%%%%%%%%%%%
%.    .      .    .%
%.%%.%.%%%%%%.%.%%.%
%......      ......%
% %%%%   %%%%%%%%% %
%       13%%24     %
%%%%%%%%%%%%%%%%%%%%
