%%%%%%%%%%%%%%%%%%%%
%.    .      .    .%
%.%%.%.%%%%%%.%.%%.%
%......      ......%
%          %    %%%%
%       13      %24%
%%%%%%%%%%%%%%%%%%%%
